A#B                #####
 ######### ####### #####
   ####### ####### #####
## ## # ## ####### #####
##      ## ####### #####
## ####            #####
##  ### ###### #########
###     ###### #########
### ########## #########
### ########## #########
### ########## #########
############## #########
########################