###B                 ########
#   ### ###############   # #
# ####                # # # #
############## ###### # # # #
#                     # # # #
# ####### ########### # # # #
#   ##                # # # #
# # ## ### ## ######### # # #
# #    #   ####         # # #
# # ## ################ # # #
### ##             #### # # #
### ######### #### ## # # # #
###             ##    # # # #
############### ####### # # #
######                  #   #
A      ######################
